11111101
10111001
10000011
10110101
10001101
10100011
10111111
10111111