00010101
10000000
00000001
10000000
00000001
11010000
10010001
10110100