1111111111101111
1000000000010001
1000000000010001
1000100000010001
1000100000010001
1000100000010001
1000100000010001
1000100000010001
1000100000010001
1000100000010001
1000100000010001
1000100000010001
1000111111110001
1000000000000001
1000000000000001
1011111111111111