1111111111111101
1001000001100001
1001001111000111
1001101000000001
1000100011111111
1110110111010001
1010000000010111
1011111110010001
1000000010000001
1101111111111001
1000000000001001
1101111011001001
1000000001001001
1011111111001001
1000000000000001
1011111111111111