00000001
00000001
00000001
00000001
00000001
00000001
00010001
11111111