1111111111111101
1001000010001001
1000001010011011
1001001010000001
1000001010011111
1100001011010001
1000001000010001
1001111010010001
1000000010010001
1111101111110001
1000000000000001
1001110000000001
1000010000000001
1011010000000001
1010010000000001
1011111111111111