11111101
10111001
10001011
10111001
10001101
10101001
10100001
10111111